{
  "criticalTiles": [],
  "use_crystals": false,
  "use_pits": false,
  "use_portals": false,
  "use_fragile": true,
  "no_basic": false,
  "width": 12,
  "height": 12,
  "grid": [
    ["■", " ", "■", " ", " ", " ", " ", " ", " ", "□", " ", " "],
    [" ", " ", " ", " ", " ", "□", " ", " ", " ", " ", " ", "□"],
    [" ", "■", " ", " ", "□", " ", " ", " ", " ", " ", " ", "□"],
    [" ", " ", " ", " ", "□", " ", " ", "□", " ", " ", " ", " "],
    [" ", " ", " ", "□", " ", "□", "■", "□", " ", "□", "□", " "],
    [" ", " ", "□", " ", "◎", "□", "□", " ", " ", " ", " ", " "],
    [" ", " ", " ", " ", "□", " ", " ", " ", " ", " ", "□", " "],
    ["■", " ", " ", " ", " ", "□", " ", "◎", " ", " ", "■", " "],
    [" ", " ", " ", " ", " ", " ", " ", "□", "■", " ", " ", "□"],
    [" ", " ", " ", " ", " ", "■", " ", " ", " ", " ", "□", " "],
    [" ", " ", " ", " ", " ", " ", " ", " ", " ", " ", " ", " "],
    [" ", " ", " ", " ", " ", " ", " ", " ", " ", " ", " ", " "]
  ],
  "orbs": [{
    "index": -1,
    "in_pit": false,
    "x": 9,
    "y": 7
  }, {
    "index": -1,
    "in_pit": false,
    "x": 0,
    "y": 10
  }]
}
